C 234,244,2
NO ./textures/sand.xpm
SO ./textures/wood.xpm
R  1600 900
EA ./textures/stone.xpm
WE ./textures/redbrick.xpm
S ./textures/s_pillar.xpm
F  15,25,255

   1111111111111111111111111111111111111111111111111111111111111111111
 11111111111111111111111111111111111111111111111100000000000000000000211                           
        10000000001100000000000000000000000000000000000000000000000000S11111111
        1011000001110000002000001111111111111111110000111111111111120001
        1001000000000000000000001                100001           100001
111111111011000001110000002000001                100001           100201
100000000011000001110111111111111      111111111110000111         100001
 1110111111111011100000010001          100000000000000001         102001
11110111111111011101010010001          100001111111110001         100001
110000001101010111000000100011111111111100001       10001         120001
100020000000000011000000000000000000000000021       10001         100021
100000000000000011010100100011111111111100001       10001         100001
1000000111010101111101111000111        100001111111110001         120001
10110111 1110101 101111010001          100000000000000001         100001
10111111 1110111 111111111111          111111110001111111         100201
101        101                                10001               100001
101        101                                10001               100001
101        101                      111111111110001111111111111111102001
101        1011111111111111111111111100000000000000000000000000000000001
101        1000000000000000000000000000000000000001111111111111111100001
101        1111111111111111111111111111111100011111               100001
101                                       10001                   100021
101                                       10001                   100021
101                                       10001                   120001
101                                       10001                   100001
101                                       100011111111111111111111100201
101111111111111111111111111111111111111111100000000000000000000000000001
100000000000000000000000000000000000000000000000000000000000000000000021
111111200021111111111111111111111111111111111111111111111111111111111111
11111120002111
10000000000001
10000000000000111111111
11111000000000000000001
     111100000000001111
     10000000000111
      1000000000011                           11111
       111111000000111111111111               10001
        1111111111000000000000111111111       10001
                  111111000000000000001111111111111
             1111111111000000000000001
    1111111110000000000000011111111111
    1000000000000000000000001
    1000000000000000000000001
    1000000111111111111111111
    11111111111
    1111111111
    1000000011111111       111
    1000000000000001111111110111
     11111111111111000000000001
                   11011111111
                    101      11
                   1000111111001
                   1000000001111
                    100111121
                     1111111